#####
#A @o#
#   ######
#o@     @o#
##########