   ##########
####    ##  #
#  @o o   @A#
#      ###  #
#   #### ####
#####