##########
#A @o    #
#   ######
#o@    @o#
##########