############
#          #
#    A@ o  #
######     #
####     @o#
############